11111111111111
1............1
1.1..1..m..c.1
1.1c.1....1..1
1.1..1.11.1..1
1.1111....1..1
1.1.......1.m1
1.1.......1..1
1.1..........1
1.1.....1111.1
1.1..........1
1...1111.c...1
1P....m......1
11111111111111
